qus	ans
Evyn	Green
Erich	Fuscia
Thaddeus	Violet
Bald	Goldenrod
Emyle	Fuscia
Port	Crimson
Essa	Crimson
Jarrad	Aquamarine
Kaile	Yellow
Andra	Aquamarine
Annadiana	Red
Rahel	Blue
Ekaterina	Turquoise
Tadeo	Aquamarine
Leontine	Green
Roderigo	Turquoise
Nathanil	Teal
Giraud	Mauv
Karl	Crimson
Verile	Purple
Laurianne	Fuscia
Heywood	Aquamarine
Ermina	Khaki
Curran	Maroon
Roxine	Teal
Hanson	Aquamarine
Rodrique	Purple
Edward	Puce
Gerardo	Maroon
Donavon	Violet
Reginauld	Violet
Gerick	Violet
Marlow	Indigo
Cassandre	Aquamarine
Barbe	Purple
Leila	Goldenrod
Karrah	Aquamarine
Erinna	Teal
Philomena	Aquamarine
Bili	Red
